##################################################
############                           ###########
##########   ######################### ###########
##########  ####### ################   ###########
##########  ####### ############# B##   ##########
##########  ###           ####### ###       ######
##########  ####### #############     ##    ######
##########  ####### ####################    ######
##########                     ##########  #######
###########  ############ ###############  #######
####  ######  ########### ###############    #####
##   ########    #######  #############   ########
#  ##### ####### ######## #############  #########
# #####  ####### ########  ############  #########
# #####  ######     #####    ##########  #########
# #####  ###    #########                   ######
# ####        ####################################
#A     ###########################################
##################################################
